111111111111111111
100C1C000000000001
10111111000000C1E1
1000P0000011111101
10000C0000100CC101
100C000000100CC101
100000000010000101
110111111110000001
1C0000000000000C01
111111111111111111