11111
1C001
100E1
1P001
11111
