111111111111111111
100C1C000000C01001
1011111101100C1E01
100P00000011100001
10000C000010C00101
1000000000100C0101
10000000001C0C0001
110111111110000001
1C00C0C00000000C01
111111111111111111